Abdominal aortic aneurysm : acupressure : sweat therapy : serotherapy : biotherapy : combination therapy : photothermal therapy : pharmacotherapy : ozone therapy : laser therapy
Acne : abortive therapy : alternative therapy : serotherapy : energy therapy : Chinese food therapy : curative therapy : phototherapy : halotherapy : herbal therapy : investigational therapy
Acute cholecystitis : acupuncture : stepladder therapy : empiric therapy : biotherapy : cold compression therapy : phytotherapy
Acute lymphoblastic leukaemia : abortive therapy : acupressure : adjuvant therapy : antiserum therapy : TK cell therapy : Auger therapy : autologous immune enhancement therapy : brachytherapy : chemotherapy : pharmacotherapy : hormonal therapy : horticultural therapy


Acute myeloid leukaemia : adjuvant therapy : alternative therapy : antibody therapy : antiserum therapy : blood irradiation therapy : brachytherapy : chemotherapy : cobalt therapy : pharmacotherapy


Acute pancreatitis : adjuvant therapy : antibody therapy : empiric therapy : cytotherapy : craniosacral therapy : pharmacotherapy
Addison's disease : abortive therapy : serotherapy : empiric therapy : chiropractic therapy : maintenance therapy
Alcohol-related liver disease : acupuncture : animal-assisted therapy : definitive therapy : physical therapy : pharmacotherapy
Allergic rhinitis : thalassotherapy : sweat therapy : curative therapy : particle therapy : investigational therapy
Allergies : acupressure : tai chi therapy : biotherapy : curative therapy : particle therapy : immunotherapy : magnet therapy : monoclonal antibody therapy
Alzheimer's disease : animal-assisted therapy : antibody therapy : antiserum therapy : equine therapy : horticultural therapy
Anal cancer : adjuvant therapy : antibody therapy : virotherapy : targeted therapy : epigenetic therapy : Auger therapy : brachytherapy : cytotherapy : chelation therapy : chemotherapy : cobalt therapy : polychemotherapy : phytotherapy : mesotherapy : microwave thermotherapy
Anaphylaxis : alternative therapy : water cure : biotherapy : cold compression therapy : occupational therapy
Angioedema : abortive therapy : acupuncture : Chinese food therapy : cryotherapy : osmotherapy : halotherapy : hydrotherapy
Ankylosing spondylitis : supportive therapy : spa therapy : combination therapy : photothermal therapy : photodynamic therapy : halotherapy
Anorexia nervosa : abortive therapy : quack therapies : aquarium therapy : counseling : dietary therapy : hydrotherapy : intravenous therapy : medical nutrition therapy
Anxiety : abortive therapy : stepdown therapy : speech therapy : epigenetic therapy : balneotherapy : bioidentical hormone replacement therapy : herbal therapy : hormonal therapy : mindfullness

Appendicitis : abortive therapy : biotherapy : curative therapy : definitive therapy : proton therapy : neutron therapy
Arthritis (general) : antiserum therapy : thermotherapy : curative therapy : electrohomeopathy : immunosuppressive therapy
Asbestosis : abortive therapy : sonodynamic therapy : definitive therapy : proton therapy : investigational therapy
Asthma : alternative therapy : antibody therapy : respiratory therapy : speleotherapy : physical therapy : medical gas therapy
Atopic eczema : abortive therapy : PUVA therapy : curative therapy : definitive therapy : physical therapy : pharmacotherapy : occupational therapy : manual therapy
Attention deficit hyperactivity disorder (ADHD) : abortive therapy
Autistic spectrum disorder (ASD) : tai chi therapy : serotherapy : Feldenkrais therapy : quack therapies : autism therapies : chelation therapy : ozone therapy
Bacterial vaginosis : acupressure : acupuncture : curative therapy
Benign prostate enlargement : animal-assisted therapy : chiropractic therapy
Bile duct cancer (cholangiocarcinoma) : adjuvant therapy : virotherapy : cell transfer therapy : neutron capture therapy of cancer
Binge eating : water cure : stepdown therapy : empiric therapy : aromatherapy : chronotherapy : counseling : dark therapy : dietary therapy : protein therapy : phage therapy : grape therapy : leech therapy
Bipolar disorder : wake therapy : systemic therapy : sound therapy : equine therapy : retail therapy : chronotherapy : counseling : crystal therapy : manual therapy : martial arts therapy
Bladder cancer : adjuvant therapy : thalassotherapy : targeted therapy : chemotherapy : consolidation therapy : investigational therapy : magnet therapy
Blood poisoning (sepsis) : tai chi therapy : spa therapy : electrotherapy : inversion therapy
Bone cancer : adjuvant therapy : alternative therapy : antibody therapy : radiation therapy : pulsed electromagnetic field therapy : chemotherapy : cobalt therapy : neutron capture therapy of cancer : herbal therapy

Bowel cancer : adjuvant therapy : antibody therapy : virotherapy : cell transfer therapy
Bowel incontinence : abortive therapy : acupuncture : empiric therapy
Bowel polyps : water cure : stepladder therapy : energy therapy : Chinese food therapy
Brain stem death : stepladder therapy : empiric therapy : cold compression therapy : craniosacral therapy
Brain tumours : adjuvant therapy : antibody therapy : stereotactic radiation therapy : fast neutron therapy : electron therapy : brachytherapy : cytotherapy : cell transfer therapy : chemotherapy : craniosacral therapy : polychemotherapy : hormonal therapy : microwave thermotherapy


Breast cancer : adjuvant therapy : alternative therapy : antibody therapy : salvage therapy : epigenetic therapy : Auger therapy : brachytherapy : cell transfer therapy : chemotherapy : cobalt therapy : photothermal therapy

Bronchiectasis : animal-assisted therapy : electrotherapy : polytherapy : photodynamic therapy
Bronchitis : sweat therapy : biotherapy : electrotherapy : hyperthermia therapy
Bulimia : acupressure : electrotherapy : biotherapy : combination therapy
Bunion : urine therapy : electrotherapy : combination therapy
Carcinoid syndrome and carcinoid tumours : electron therapy : chelation therapy : chemotherapy : cytoluminescent therapy : diesel therapy : laser therapy
Catarrh : stepdown therapy : biotherapy : Chinese food therapy : curative therapy : herbal therapy : mud therapy : molecular chaperone therapy
Cellulitis : acupuncture : antiserum therapy : curative therapy
Cervical cancer : adjuvant therapy : empiric therapy : radiation therapy : cell transfer therapy : chemotherapy : cobalt therapy : crystal therapy : diesel therapy : ozone therapy : neutron capture therapy of cancer
Chest infection : abortive therapy : curative therapy : definitive therapy
Chest pain : sweat therapy : empiric therapy : monotherapy
Chickenpox : alternative therapy : biotherapy : contrast bath therapy
Chilblains : water cure : spa therapy : electrotherapy : definitive therapy : magnet therapy
Chlamydia : tai chi therapy : electrotherapy : curative therapy : photothermal therapy
Chronic fatigue syndrome : alternative therapy : Waon therapy : cold compression therapy : pharmacotherapy
Chronic kidney disease : animal-assisted therapy : extracorporeal shockwave therapy : induction therapy : investigational therapy
Chronic lymphocytic leukaemia : TK cell therapy : epigenetic therapy
Chronic myeloid leukaemia : TK cell therapy : targeted therapy : autologous immune enhancement therapy : monoclonal antibody therapy
Chronic obstructive pulmonary disease : sonodynamic therapy : respiratory therapy : climatotherapy : photothermal therapy : pharmacotherapy : oxygen therapy : negative air ionization therapy : hyperbaric oxygen therapy
Chronic pancreatitis : animal-assisted therapy : antibody therapy : craniosacral therapy
Cirrhosis : urine therapy : energy therapy : biotherapy
Clostridium difficile : abortive therapy : acupuncture : chiropractic therapy
Coeliac disease : stepdown therapy : serotherapy : biotherapy : polytherapy : phytotherapy : photodynamic therapy : pharmacotherapy
Cold sore : Waon therapy : serotherapy : biotherapy : polytherapy : hydrotherapy : molecular therapy
Coma : sweat therapy : stepladder therapy : consolidation therapy : intravenous therapy : medical nutrition therapy
Common cold : sweat therapy : empiric therapy : consolidation therapy : pharmacotherapy : hyperthermia therapy : monotherapy
Common heart conditions : epigenetic therapy : respiratory therapy : oxygen therapy : negative air ionization therapy : herbal therapy
Congenital heart disease : abortive therapy : acupuncture : empiric therapy : respiratory therapy : climatotherapy : oxygen therapy : investigational therapy
Conjunctivitis : stepdown therapy : Chinese food therapy : definitive therapy
Constipation : alternative therapy : cryotherapy : curative therapy : occupational therapy
Coronavirus (COVID-19) : acupressure : acupuncture : alternative therapy : antiserum therapy : aquarium therapy : crystal therapy : laser therapy : low level laser therapy
Cough (general) : stepdown therapy : aromatherapy : cryotherapy : definitive therapy : molecular therapy
Crohn's disease : animal-assisted therapy : antibody therapy : antiserum therapy : immunosuppressive therapy
Croup : animal-assisted therapy : combination therapy : definitive therapy : phototherapy
Cystic fibrosis : water cure : urine therapy : empiric therapy : pharmacotherapy : molecular chaperone therapy
Cystitis : alternative therapy : cryotherapy : curative therapy : horticultural therapy : investigational therapy
Deafblindness : animal-assisted therapy : animal-assisted therapy : gene therapy : monotherapy
Deep vein thrombosis : tai chi therapy : exercise therapy : curative therapy
Dehydration : acupuncture : alternative therapy : serotherapy : rehydration therapy : oral rehydration therapy : intravenous therapy

Dementia with Lewy bodies : alternative therapy : equine therapy : epigenetic therapy
Dental abscess : thalassotherapy : biotherapy : curative therapy : fluoride therapy
Depression (other than postnatal) : wake therapy : transgender hormone therapy : systemic therapy : sound therapy : sex therapy : epigenetic therapy : retail therapy : pulsed electromagnetic field therapy : art therapy : bioidentical hormone replacement therapy : chronotherapy : counseling : drug therapy : lithium therapy
Dermatitis herpetiformis : abortive therapy : consolidation therapy : curative therapy : pharmacotherapy : ichthyotherapy : investigational therapy : maggot therapy
Diabetes (other than type 1 or 2) : androgen replacement therapy : transdermal continuous oxygen therapy : stem cell therapy : epigenetic therapy : Auger therapy : brachytherapy : pharmacotherapy : hyperbaric oxygen therapy : molecular chaperone therapy
Diarrhoea : alternative therapy : electrotherapy : curative therapy : protein therapy
Discoid eczema : sweat therapy : electrotherapy : PUVA therapy : magnet therapy
Diverticular disease and diverticulitis : Chinese food therapy : prolotherapy : pharmacotherapy
Dizziness (Lightheadedness) : tai chi therapy : definitive therapy : proton therapy : photodynamic therapy : occupational therapy : neutron therapy : halotherapy

Dry mouth : sweat therapy : supportive therapy : cold compression therapy
Dysphagia (swallowing problems) : acupressure : acupuncture : chiropractic therapy : cold compression therapy : crystal therapy : ozone therapy : herbal therapy
Dystonia : water cure : stepdown therapy : curative therapy : electrohomeopathy
Earache : animal-assisted therapy : speleotherapy : phytotherapy
Earwax build-up : alternative therapy : empiric therapy : cryotherapy : definitive therapy : electromagnetic therapy : physical therapy
Ebola virus disease : speleotherapy : energy therapy : empiric therapy : definitive therapy : physical therapy
Ectopic pregnancy : urine therapy : empiric therapy : hydrotherapy : investigational therapy
Endometriosis : alternative therapy : empiric therapy : definitive therapy
Epilepsy : acupuncture : tai chi therapy : stepladder therapy : gene therapy
Erectile dysfunction (impotence) : sex therapy : combination therapy : definitive therapy : occupational therapy : manual therapy
Escherichia coli (E. coli) O157 : radiation therapy : curative therapy : phototherapy
Ewing sarcoma : adjuvant therapy : serotherapy : chelation therapy

Eye cancer : adjuvant therapy : antibody therapy : targeted therapy : salvage therapy : qigong therapy : cell transfer therapy : chemotherapy : cytoluminescent therapy : pharmacotherapy : investigational therapy : laser therapy : microwave thermotherapy
Febrile seizures : sweat therapy : biotherapy : Chinese food therapy : electroconvulsive therapy
Fever : animal-assisted therapy : thalassotherapy : empiric therapy : maintenance therapy : mesotherapy

Fibroids : stepdown therapy : electrotherapy
Fibromyalgia : speleotherapy : empiric therapy : definitive therapy
Flatulence : animal-assisted therapy : water cure : proton therapy : protein therapy : pharmacotherapy
Flu : sweat therapy : bioidentical hormone replacement therapy : definitive therapy : photodynamic therapy : hormonal therapy
Foetal alcohol syndrome : acupressure : acupuncture : definitive therapy
Food poisoning : spa therapy : biotherapy : curative therapy
Fungal nail infection : abortive therapy : biotherapy : herbal therapy : horticultural therapy
Gallbladder cancer : adjuvant therapy : radiation therapy : pharmacotherapy : neutron capture therapy of cancer : herbal therapy
Gallstones : acupuncture : urine therapy : biotherapy : polytherapy
Ganglion cyst : alternative therapy : animal-assisted therapy : consolidation therapy
Gastroenteritis : supportive therapy : empiric therapy : phototherapy
Gastro-oesophageal reflux disease (GORD) : biotherapy : chiropractic therapy : craniosacral therapy : crystal therapy : laser therapy : magnet therapy
Genital herpes : stepladder therapy : speleotherapy : curative therapy : investigational therapy
Genital warts : serotherapy : biotherapy : cold compression therapy : photothermal therapy
Germ cell tumours : antibody therapy : electron therapy : definitive therapy : physical therapy
Glandular fever : acupuncture : tai chi therapy : biotherapy : Chinese food therapy : definitive therapy : diesel therapy : ozone therapy
Gonorrhoea : alternative therapy : empiric therapy : balneotherapy : mesotherapy
Gout : spa therapy : empiric therapy : biotherapy : combination therapy
Gum disease : animal-assisted therapy : thalassotherapy : investigational therapy
Haemorrhoids (piles) : sweat therapy : speleotherapy : empiric therapy : occupational therapy : manual therapy
Hairy cell leukaemia : water cure : TK cell therapy : phytotherapy : magnet therapy
Hand, foot and mouth disease : alternative therapy : curative therapy : mesotherapy
Hay fever : acupressure : energy therapy : curative therapy : immunotherapy : monoclonal antibody therapy
Head and neck cancer : adjuvant therapy : virotherapy : epigenetic therapy : radiation therapy : chemotherapy : crystal therapy : cytoluminescent therapy : pharmacotherapy : herbal therapy
Head lice and nits : stepdown therapy : empiric therapy : herbal therapy
Headaches : alternative therapy : thermotherapy : consolidation therapy : diathermy : photodynamic therapy : pharmacotherapy : neurologic music therapy
Hearing loss : stepladder therapy : qigong therapy : electrohomeopathy : monotherapy
Heart failure : alternative therapy : Waon therapy : stem cell therapy : epigenetic therapy : radiation therapy : respiratory therapy : cardiac resynchronization therapy : negative air ionization therapy : herbal therapy : investigational therapy
Hepatitis A : acupuncture : stepladder therapy : biotherapy : monotherapy : molecular therapy
Hepatitis B : animal-assisted therapy : biotherapy
Hepatitis C : water cure : urine therapy : biotherapy : Chinese food therapy : definitive therapy : proton therapy : neutron therapy
Hiatus hernia : stepdown therapy : combination therapy : definitive therapy : pharmacotherapy
High cholesterol : tai chi therapy : empiric therapy : definitive therapy : pharmacotherapy : monotherapy
HIV : adjuvant therapy : sweat therapy : salvage therapy : phototherapy : autologous immune enhancement therapy : helminthic therapy : immunotherapy : intravenous immunoglobulin therapy : monoclonal antibody therapy
Hodgkin lymphoma : acupressure : electrotherapy : PUVA therapy : definitive therapy : proton therapy : pharmacotherapy


Huntington's disease : animal-assisted therapy : enzyme replacement therapy : phytotherapy : induction therapy
Hyperglycaemia (high blood sugar) : alternative therapy : androgen replacement therapy : blood irradiation therapy
Hyperhidrosis : Waon therapy : supportive therapy : polytherapy
Hypoglycaemia (low blood sugar) : acupuncture : androgen replacement therapy : blood irradiation therapy
Idiopathic pulmonary fibrosis : speleotherapy : respiratory therapy : climatotherapy : oxygen therapy : hyperbaric oxygen therapy : monotherapy
Impetigo : sweat therapy : spa therapy : empiric therapy : curative therapy : particle therapy
Indigestion : alternative therapy : thalassotherapy : serotherapy : chiropractic therapy : dietary therapy : pharmacotherapy : particle therapy : investigational therapy : leech therapy
Ingrown toenail : alternative therapy : empiric therapy : combination therapy
Inherited heart conditions : water cure : electrotherapy : cardiac resynchronization therapy : chelation therapy : diesel therapy
Insomnia : water cure : stepladder therapy : sound therapy : curative therapy : photodynamic therapy
Iron deficiency anaemia : abortive therapy : water cure : stepladder therapy : autologous immune enhancement therapy : crystal therapy : halotherapy : laser therapy
Irritable bowel syndrome (IBS) : stepdown therapy : curative therapy : definitive therapy : physical therapy
Irritable hip : acupressure : acupuncture : water cure : consolidation therapy : occupational therapy : mesotherapy
Itching : alternative therapy : speleotherapy : cold compression therapy : definitive therapy : pharmacotherapy : hydrotherapy
Itchy bottom : alternative therapy : stepladder therapy : exercise therapy : biotherapy : grape therapy : magnet therapy
Kaposi's sarcoma : animal-assisted therapy : cold compression therapy : intravenous immunoglobulin therapy : investigational therapy
Kidney cancer : adjuvant therapy : antibody therapy : virotherapy : targeted therapy : salvage therapy : radiation therapy : Auger therapy : brachytherapy : cytotherapy : cell transfer therapy : chemotherapy : polychemotherapy : pharmacotherapy : neutron capture therapy of cancer : hormonal therapy
Kidney infection : alternative therapy : urine therapy : extracorporeal shockwave therapy : qigong therapy : occupational therapy
Kidney stones : water cure : tai chi therapy : extracorporeal shockwave therapy : investigational therapy : monotherapy
Labyrinthitis : alternative therapy : energy therapy : phototherapy : horticultural therapy
Lactose intolerance : tai chi therapy : stepladder therapy : magnet therapy
Langerhans cell histiocytosis : alternative therapy : empiric therapy : autologous immune enhancement therapy : diesel therapy : ozone therapy : monoclonal antibody therapy
Laryngeal (larynx) cancer : adjuvant therapy : empiric therapy : Chinese food therapy
Laryngitis : alternative therapy : stepladder therapy : cryotherapy : electromagnetic therapy
Leg cramps : supportive therapy : stepdown therapy : serotherapy : electrotherapy : physiotherapy : pharmacotherapy : massage therapy
Lichen planus : sweat therapy : supportive therapy : aquarium therapy
Liver cancer : adjuvant therapy : speleotherapy : serotherapy : epigenetic therapy : radiation therapy : brachytherapy : chemotherapy : crystal therapy : neutron capture therapy of cancer : hormonal therapy : molecular therapy
Liver disease : acupressure : acupuncture : combination therapy : cupping therapy
Liver tumours : animal-assisted therapy : thalassotherapy : epigenetic therapy : chemotherapy : halotherapy : herbal therapy
Loss of libido : alternative therapy : sex therapy : counseling : photodynamic therapy : magnet therapy
Lung cancer : adjuvant therapy : alternative therapy : water cure : targeted therapy : stereotactic radiation therapy : respiratory therapy : chelation therapy : chemotherapy : induction therapy : medical gas therapy
Lupus : alternative therapy : water cure : consolidation therapy : electrohomeopathy : hydrotherapy
Lyme disease : water cure : water cure : consolidation therapy : intravenous therapy : molecular therapy
Lymphoedema : water cure : stepladder therapy : curative therapy : definitive therapy : osmotherapy : investigational therapy
Lymphogranuloma venereum (LGV) : animal-assisted therapy : definitive therapy : pharmacotherapy
Malaria : animal-assisted therapy : stepladder therapy : biotherapy : definitive therapy
Malignant brain tumour (cancerous) : tai chi therapy : salvage therapy : fast neutron therapy : electron therapy : radiation therapy : Auger therapy : brachytherapy : cytotherapy : chemotherapy : pharmacotherapy : occupational therapy : neutron capture therapy of cancer : hormonal therapy : microwave thermotherapy
Malnutrition : urine therapy : speleotherapy : balneotherapy : photothermal therapy : herbal therapy
Measles : acupuncture : stepdown therapy : empiric therapy : curative therapy : phytotherapy : pharmacotherapy
Meningitis : abortive therapy : acupuncture : alternative therapy : biotherapy : biotherapy : pharmacotherapy

Mesothelioma : acupuncture : spa therapy : combination therapy : hydrotherapy
Middle ear infection (otitis media) : acupressure : cupping therapy : photodynamic therapy : investigational therapy
Migraine : animal-assisted therapy : stepladder therapy : sound therapy : electrotherapy : retail therapy : crystal therapy : pharmacotherapy : herbal therapy : laser therapy : low level laser therapy : magnet therapy

Motor neurone disease (MND) : acupuncture : curative therapy : phonemic neurological hypochromium therapy
Mouth cancer : adjuvant therapy : antibody therapy : virotherapy : chelation therapy : chemotherapy : cytoluminescent therapy : diesel therapy : molecular therapy
Mouth ulcer : sweat therapy : serotherapy : cold compression therapy : oral rehydration therapy : medical nutrition therapy : mesotherapy
Multiple myeloma : alternative therapy : empiric therapy : contrast bath therapy : investigational therapy
Multiple sclerosis (MS) : acupressure : acupuncture : water cure : contrast bath therapy : prolotherapy : physiotherapy
Mumps : sweat therapy : stepladder therapy : stepladder therapy : chiropractic therapy
Meniere's disease : stepladder therapy : speleotherapy : consolidation therapy : pharmacotherapy : monotherapy
Nasal and sinus cancer : adjuvant therapy : thalassotherapy : curative therapy : definitive therapy : pharmacotherapy : neutron capture therapy of cancer : hormonal therapy : investigational therapy
Nasopharyngeal cancer : adjuvant therapy : water cure : curative therapy : definitive therapy : proton therapy : pharmacotherapy : neutron therapy : induction therapy
Neuroblastoma : water cure : urine therapy : cryotherapy : polytherapy : phonemic neurological hypochromium therapy : herbal therapy : monotherapy

Neuroendocrine tumours : tai chi therapy : epigenetic therapy : enzyme replacement therapy : electron therapy : chemotherapy : phonemic neurological hypochromium therapy
Non-alcoholic fatty liver disease (NAFLD) : speleotherapy : aquarium therapy : photodynamic therapy
Non-Hodgkin lymphoma : alternative therapy : animal-assisted therapy : water cure : fast neutron therapy : epigenetic therapy : Auger therapy : brachytherapy

Norovirus : abortive therapy : acupuncture : empiric therapy : diathermy : pharmacotherapy : inversion therapy
Nosebleed : water cure : supportive therapy : biotherapy : consolidation therapy : pharmacotherapy : mesotherapy
Obesity : water cure : Waon therapy : empiric therapy : curative therapy : dietary therapy : protein therapy : pharmacotherapy : phage therapy
Obsessive compulsive disorder (OCD) : alternative therapy : Chinese food therapy : counseling : crystal therapy : pharmacotherapy : occupational therapy : monotherapy
Obstructive sleep apnoea : water cure : combination therapy : curative therapy : definitive therapy : pharmacotherapy
Oesophageal cancer : adjuvant therapy : spa therapy : curative therapy : diesel therapy : investigational therapy : molecular therapy
Oral thrush : animal-assisted therapy : stepladder therapy : horticultural therapy : monotherapy
Osteoarthritis : water cure : tai chi therapy : curative therapy : electromagnetic therapy : gene therapy : immunosuppressive therapy
Osteoporosis : alternative therapy : tai chi therapy
Osteosarcoma : abortive therapy : acupuncture : stepladder therapy : enzyme replacement therapy : balneotherapy : diesel therapy : investigational therapy
Otitis externa : acupressure : acupuncture : cold compression therapy
Ovarian cancer : adjuvant therapy : antibody therapy : water cure : virotherapy : targeted therapy : salvage therapy : radiation therapy : brachytherapy : cytotherapy : chelation therapy : chemotherapy : polychemotherapy : hormonal therapy

Ovarian cyst : stepdown therapy : empiric therapy : destination therapy : photodynamic therapy
Overactive thyroid : sweat therapy : speleotherapy : consolidation therapy : photodynamic therapy : pharmacotherapy : pharmacotherapy : monotherapy
Paget's disease of the nipple : stepladder therapy : cryotherapy : electromagnetic therapy
Pancreatic cancer : adjuvant therapy : animal-assisted therapy : radiation therapy : chelation therapy : chemotherapy : cytoluminescent therapy : pharmacotherapy : induction therapy : monotherapy
Panic disorder : thalassotherapy : speleotherapy : contrast bath therapy : counseling : drug therapy : pharmacotherapy : horticultural therapy : induction therapy : investigational therapy : lithium therapy
Parkinson's disease : water cure : urine therapy : empiric therapy : contrast bath therapy : neurologic music therapy : gene therapy
Pelvic inflammatory disease : thermotherapy : energy therapy : chiropractic therapy : diathermy : pharmacotherapy
Pelvic organ prolapse : water cure : serotherapy : cupping therapy : curative therapy : pharmacotherapy : hydrotherapy
Penile cancer : acupressure : acupuncture : adjuvant therapy : antibody therapy : targeted therapy : epigenetic therapy : chemotherapy : diesel therapy : phonemic neurological hypochromium therapy : neutron capture therapy of cancer : molecular therapy : microwave thermotherapy
Peripheral neuropathy : stepladder therapy : speech therapy : sonodynamic therapy : exercise therapy : phonemic neurological hypochromium therapy : investigational therapy
Personality disorder : abortive therapy : sound therapy : sonodynamic therapy : sex therapy : qigong therapy : brachytherapy : cytotherapy : herbal therapy : monotherapy
Pleurisy : alternative therapy : tai chi therapy : biotherapy : phytotherapy : halotherapy : monotherapy
Pneumonia : animal-assisted therapy : serotherapy : biotherapy : definitive therapy : physical therapy : pharmacotherapy
Polymyalgia rheumatica : water cure : electrotherapy : aurotherapy : Chinese food therapy : platin therapy : pharmacotherapy : horticultural therapy
Post-traumatic stress disorder (PTSD) : abortive therapy : sex therapy : counseling : retail therapy : occupational therapy : lithium therapy
Postnatal depression : systemic therapy : supportive therapy : sound therapy : retail therapy : pulsed electromagnetic field therapy : art therapy : chronotherapy : counseling : drug therapy : neurologic music therapy : lithium therapy

Pressure ulcers : alternative therapy : spa therapy : curative therapy : investigational therapy : investigational therapy : magnet therapy
Prostate cancer : adjuvant therapy : antibody therapy : salvage therapy : fast neutron therapy : empiric therapy : chelation therapy : chemotherapy : pharmacotherapy : induction therapy
Psoriasis : abortive therapy : antiserum therapy : ultraviolet light therapy : empiric therapy : PUVA therapy
Psoriatic arthritis : abortive therapy : curative therapy : phototherapy : immunosuppressive therapy : monotherapy
Psychosis : alternative therapy : tai chi therapy : empiric therapy : chronotherapy : pharmacotherapy : ozone therapy
Pubic lice : water cure : sweat therapy : stepladder therapy : definitive therapy
Rare tumours : antibody therapy : water cure : speleotherapy : fast neutron therapy : radiation therapy : brachytherapy : cytotherapy : cell transfer therapy : chemotherapy : polychemotherapy
Raynaud's phenomenon : thalassotherapy : supportive therapy : monotherapy : molecular therapy
Reactive arthritis : animal-assisted therapy : serotherapy : balneotherapy : immunosuppressive therapy
Restless legs syndrome : alternative therapy : stepladder therapy : equine therapy : pharmacotherapy : inversion therapy : massage therapy
Retinoblastoma : abortive therapy : tai chi therapy : curative therapy : gene therapy : magnet therapy : mesotherapy

Rhabdomyosarcoma : supportive therapy : spa therapy : empiric therapy
Rheumatoid arthritis : speleotherapy : enzyme replacement therapy : aurotherapy : platin therapy : pharmacotherapy : immunosuppressive therapy
Ringworm and other fungal infections : stepladder therapy : consolidation therapy : pharmacotherapy : monotherapy
Rosacea : supportive therapy : stepladder therapy : serotherapy : pharmacotherapy : hydrotherapy
Scabies : acupressure : acupuncture : electrotherapy : cold compression therapy : hydrotherapy
Scarlet fever : alternative therapy : biotherapy : chiropractic therapy : pharmacotherapy : hydrotherapy : investigational therapy
Schizophrenia : animal-assisted therapy : speech therapy : destination therapy : herbal therapy : magnet therapy : martial arts therapy
Scoliosis : water cure : sweat therapy : quack therapies : combination therapy : photothermal therapy : pharmacotherapy : mud therapy : monotherapy
Septic shock : abortive therapy : acupuncture : water cure : crystal therapy : electromagnetic therapy : pharmacotherapy : horticultural therapy : molecular therapy
Shingles : animal-assisted therapy : Chinese food therapy : definitive therapy : photothermal therapy : magnet therapy
Shortness of breath : water cure : stepdown therapy : curative therapy : definitive therapy : physiotherapy : photothermal therapy : pharmacotherapy : oxygen therapy : hyperbaric oxygen therapy
Sickle cell disease : water cure : speleotherapy : autologous immune enhancement therapy : pharmacotherapy : halotherapy : monotherapy : monoclonal antibody therapy
Sinusitis : acupressure : alternative therapy : urine therapy : cold compression therapy : pharmacotherapy : occupational therapy : investigational therapy
Sjogren's syndrome : animal-assisted therapy : electrotherapy : aromatherapy : investigational therapy
Skin cancer (melanoma) : adjuvant therapy : antibody therapy : salvage therapy : radiation therapy : brachytherapy : cytotherapy : chelation therapy : neutron capture therapy of cancer : ichthyotherapy : mud therapy : maggot therapy
Skin cancer (non-melanoma) : adjuvant therapy : antibody therapy : salvage therapy : empiric therapy : radiation therapy : brachytherapy : cytotherapy : diesel therapy : neutron capture therapy of cancer : hormonal therapy : induction therapy : investigational therapy : mud therapy : monotherapy : maggot therapy
Slapped cheek syndrome : thalassotherapy : tai chi therapy : contrast bath therapy : herbal therapy : mud therapy
Soft tissue sarcomas : water cure : stepladder therapy : balneotherapy

Sore throat : animal-assisted therapy : speleotherapy : empiric therapy : proton therapy : photodynamic therapy : pharmacotherapy
Spleen problems and spleen removal : alternative therapy : polytherapy : phototherapy : photodynamic therapy

Stomach ache and abdominal pain : alternative therapy : chiropractic therapy : curative therapy : pharmacotherapy : leech therapy
Stomach cancer : animal-assisted therapy : antibody therapy : virotherapy : targeted therapy : radiation therapy : brachytherapy : chemotherapy : cobalt therapy : cytoluminescent therapy : horticultural therapy
Stomach ulcer : acupressure : acupuncture : stepdown therapy : curative therapy : halotherapy : monotherapy : molecular therapy
Stress, anxiety and low mood : water cure : stepladder therapy : exercise therapy : qigong therapy : counseling : dark therapy : drug therapy : pharmacotherapy : inversion therapy : mindfullness
Stroke : supportive therapy : stepdown therapy : Chinese food therapy : destination therapy : maintenance therapy : massage therapy


Sunburn : animal-assisted therapy : spa therapy : biotherapy : cold compression therapy : magnet therapy : maintenance therapy
Swollen glands : abortive therapy : acupuncture : serotherapy : consolidation therapy : cryotherapy : diesel therapy : pharmacotherapy : mesotherapy
Syphilis : animal-assisted therapy : sweat therapy : biotherapy : cupping therapy : pharmacotherapy
Testicular cancer : adjuvant therapy : antibody therapy : antihormone therapy : pharmacotherapy : occupational therapy : manual therapy

Testicular lumps and swellings : alternative therapy : biotherapy : Chinese food therapy : cryotherapy : polytherapy : pharmacotherapy : induction therapy : mud therapy : monotherapy
Thirst : animal-assisted therapy : stepladder therapy : combination therapy : destination therapy : investigational therapy : magnet therapy
Threadworms : acupressure : water cure : speleotherapy : serotherapy : curative therapy : electrohomeopathy : pharmacotherapy : helminthic therapy : herbal therapy : host modulatory therapy
Thrush (general) : animal-assisted therapy : stepladder therapy : quack therapies : crystal therapy : curative therapy : pharmacotherapy

Thyroid cancer : adjuvant therapy : antibody therapy : tolerogenic therapy : salvage therapy : brachytherapy : cell transfer therapy : chelation therapy : chemotherapy : cobalt therapy : polychemotherapy : neutron capture therapy of cancer : microwave thermotherapy

Tinnitus : animal-assisted therapy : stepdown therapy : biotherapy : dark therapy
Tonsillitis : animal-assisted therapy : thalassotherapy : quack therapies : biotherapy : polytherapy : pharmacotherapy : hyperthermia therapy
Tooth decay : abortive therapy : water cure : stepladder therapy : balneotherapy : crystal therapy : fluoride therapy : laser therapy : low level laser therapy
Toothache : alternative therapy : tai chi therapy : empiric therapy : curative therapy : destination therapy : occupational therapy : fluoride therapy
Transient ischaemic attack (TIA) : acupressure : acupuncture : chiropractic therapy : curative therapy : hydrotherapy : induction therapy : investigational therapy
Trigeminal neuralgia : water cure : sweat therapy : speleotherapy : enzyme replacement therapy : energy therapy : curative therapy : diesel therapy : pharmacotherapy : molecular therapy
Tuberculosis (TB) : alternative therapy : tai chi therapy : combination therapy : craniosacral therapy : monotherapy
Type 1 diabetes : androgen replacement therapy : transdermal continuous oxygen therapy : tolerogenic therapy : stem cell therapy : brachytherapy : pharmacotherapy : molecular chaperone therapy
Type 2 diabetes : androgen replacement therapy : transdermal continuous oxygen therapy : thalassotherapy : stem cell therapy : quack therapies : autologous immune enhancement therapy : hyperbaric oxygen therapy : molecular chaperone therapy
Trichomonas infection : acupressure : acupuncture : biotherapy : cold compression therapy : electrohomeopathy : pharmacotherapy
Ulcerative colitis : water cure : urine therapy : stepladder therapy : biotherapy : polytherapy : phototherapy : pharmacotherapy : herbal therapy : monotherapy : magnet therapy
Underactive thyroid : water cure : tai chi therapy : biotherapy : Chinese food therapy : cupping therapy : investigational therapy
Urinary incontinence : alternative therapy : stepdown therapy : crystal therapy : definitive therapy : physical therapy : pharmacotherapy
Urinary tract infection (UTI) : supportive therapy : stepladder therapy : contrast bath therapy

Urticaria (hives) : acupressure : acupuncture : biotherapy : photodynamic therapy
Vaginal cancer : adjuvant therapy : antibody therapy : antihormone therapy : targeted therapy : salvage therapy : epigenetic therapy : radiation therapy : Auger therapy : brachytherapy : chelation therapy : chemotherapy : polychemotherapy : hormonal therapy
Vaginal thrush : alternative therapy : sweat therapy : speleotherapy : estrogen replacement therapy
Varicose eczema : abortive therapy : adjuvant therapy : animal-assisted therapy : PUVA therapy : bioidentical hormone replacement therapy : ozone therapy : halotherapy : molecular therapy
Venous leg ulcer : adjuvant therapy : tai chi therapy : PUVA therapy : chiropractic therapy : investigational therapy
Vertigo : water cure : tai chi therapy : stepdown therapy : energy therapy : curative therapy : definitive therapy : proton therapy : particle therapy : neutron therapy : inversion therapy : magnet therapy
Vitamin B12 or folate deficiency anaemia : stepladder therapy : biotherapy : curative therapy : definitive therapy : diesel therapy : proton therapy : pharmacotherapy : particle therapy
Vomiting : water cure : thalassotherapy : tai chi therapy : empiric therapy : electrotherapy : polytherapy : occupational therapy : manual therapy
Vulval cancer : adjuvant therapy : alternative therapy : antibody therapy : antihormone therapy : targeted therapy : salvage therapy : quack therapies : Auger therapy : brachytherapy : cytotherapy : chemotherapy : polychemotherapy : hormonal therapy : investigational therapy : microwave thermotherapy
Warts and verrucas : acupressure : water cure : empiric therapy : combination therapy : curative therapy : duct tape occlusion therapy : herbal therapy
Whooping cough : acupressure : acupuncture : stepladder therapy : aquarium therapy : curative therapy : photothermal therapy : horticultural therapy : induction therapy : monotherapy
Wilmsâ€™ tumour : adjuvant therapy : tai chi therapy : balneotherapy : Chinese food therapy : definitive therapy : diesel therapy : physical therapy : pharmacotherapy : horticultural therapy
Womb (uterus) cancer : adjuvant therapy : supportive therapy : quack therapies : chemotherapy : chiropractic therapy : cytoluminescent therapy : induction therapy
Yellow fever : acupressure : acupuncture : sweat therapy : serotherapy : empiric therapy : curative therapy : polytherapy : photothermal therapy : halotherapy : investigational therapy
